WE	./assets/colorstone.xpm
NO	./assets/colorstone.xpm
SO	./assets/colorstone.xpm
EA	./assets/colorstone.xpm
F	69, 222, 199
C	235, 198, 52

11111
10001
10N01
10001
11111
