   WE                            ./assets/empty.xpm 
NO      ./assets/oob.xpm


SO ./assets/wall.xpm

F   69, 222, 199

EA ./assets/floor.xpm



C 235, 198, 52

111111111111111111111111
100000000000000000000001
100000000000000000000001
100000000000000000000001
100000000000000000000001
100000000000000000000001
100000000000000000000001
100000111110000101010001
1000001   10000000000001
1000001   10000100010001
1000001   10000000000001
100000111100001010100001
100000000000000000000001
100000000000000000000001
100000S00000000000000001
100000000000000000000001
100000000000000000000001
100000000000000000000001
100000000000000000000001
11111DDD1000000000000001
100100001000000000000001
10000010D000000000000001
100100001000000000000001
100111111000000000000001
100000000000000000000001
100000000000000000000001
111111111111111111111111
